##    #
## ## #
#  #  #
# ## ##
     ##
 ######