############################################
#A             #          #     #         #
# ###### ##### # ## ####### ###### ####### #
#      #     # # ## #      #           #   #
# ####### ## # # ## # ##### ### ####### # ##
# #     # ## # # ## #     #   # #   #   # #
# # ### # ## # # ## ##### ##### ### ### # #
# #   # # ## # #    #     #   # #   #     #
# ### # ###   ###### ##### # # # # ### # #
# #   #     #        #   # # #   # #   # #
# # ############## ### # ### ##### ### # #
# # #       #    # #   # #   #       #   #
# # ####### # ## # ##### # # # ####### ###
# #         # ## #       # # #         # #
# ####### ### ## ######### # ######### # #
# #   # #   # #     #   #   #         # # #
# # # # ### # ####### # ### ######### # ##
# # # #   # #         #   # #   #     #   #
# # ##### # ############### ### ### ### #
# #     # # #     #   #     #     #   #   #
# # ### # # # ### # # # ####### ### ### # #
# #   # # #   #   # # # #   # #     #   # #
# ### # # ##### ### # # # ### # ####### # #
#   # #         #   #   #   # #   #   #   #
# ##### ####### ######### ### # ### # ####
# #   #       #         #     #   #   #   #
# # ####### ########### # ############# # #
# #       # #                             #
# ##### ### #############################B#
############################################