###                 #########
#  B###################   # #
# ####                # # # #
# ################### # # # #
#                     # # # #
##################### # # # #
#███##██████████      # # # #
#█#█##█###█##█######### # # #
#█#████#███####         # # #
#█#█##█################ # # #
###█##██████████   #### # # #
###█############## ## # # # #
###█████████████##    # # # #
######█########█####### # # #
######█####█████        #   #
███████######################